1111111111111
100100000C1E1
100P010011101
10C0110000001
1111111111111