1111111111111
1CC1CCCCCC1C1
1CCPC1CC111C1
1CCC11CCCCCC1
1CC1CCCCCC1E1
1CCCC1CC111C1
1CC1CCCCCC1C1
1CCCC1CC111C1
1CCC11CCCCCC1
1CCC11CCCCCC1
1CC1CCCCCC111
1CCCC1CC111C1
1CCC11CCCCCC1
1111111111111