111111
10PCC1
10E001
100001
100CC1
111111