1111111111111
1C01000000101
100PC10C11101
100C110000001
1001C000000E1
1000110000001
1111111111111